S O G G G G B B B O
O O G G G B O O G G
O O T G G B O O G G
S S G G G B O G G O
B B G O O S O G G G
S S S B B B B G B B
G G G G G G G G B B
S S O O G G T G O O
S S O O G G G O O O
S O O G G G O B B O



