S O G G G G B B B O
O O G G G B B O G G
O O T B G B B O G G
S S G S G B B B B B
S S S S S S S S S S
S S S S S S S S S S
G G G G B B B B B B
G G G G G G T S S S
S S S S G G G O O O
S S S S G G O B B O