G G O G O O G B G G
S B O B O G O O B O
B S G G B G G B G G
S O S O B S G B G G
B G B G G O S O B O
S G G S S B O S G G
B G S O B O B B T O
S G G B T S O B G G
S S G S S S S S G S
G S O G G B O S O S
