O S B S O G G S O G
B S O B S O O S B G
O B G S O B B O O G
S O B B S G S B O B
O B S G G B G O G O
B S G G B G B O B B
S S G S B B S B O S
B O B G O S S S O T
S S T S S O G B S S
O B S G S S O S S S
