B B S O O G S B O B
G G S S B T B B O G
O S O O O B O S O S
S G B O O S O S O G
B G B B S O O B O G
G B S B O S S G O G
S B B T B G S S O G
B O G B S S G B S O
B S O B B B S S G G
S G O S G O G G B G
