O S G O B G B S B G
B T G B O O O S S S
O B B S B O O S B B
O B S G T O S B B O
S G B B G B B S O O
G B O G B O O B O S
B B S O S G B B S S
G G G S O G G O O O
B B G S O G G S O G
G O B S O G B O G O
