G S G G B O O S B G
S T S S G G S T G S
O S S O G O S B B O
S O B O S S O O B B
O G G S S B S O G O
G G B S B S O S S G
G G O B B B G O S G
O O S B S B B O B G
S S S B B S G B O O
B B O B S B O S O S
