T G S G S G O G S B
S B G B G S B G B G
G B G S B B B O G O
S S O S B G B G O G
G B G S S B S B S G
B G S S B G G G O T
S G G B O B G G B S
B O S G G S B B S S
B B B S S B O B O G
S O O O B S S S B B
