S S B T S O G B S O
S S S B S G B O S G
B S B B S B B O O S
O O S S B B S G O S
B B B S B B O B B G
S S S B G G S G B B
G G S O B O B O T B
G O S B S O O S O B
S G B O G G O S S B
G O B G B G B S S O
