B O B S S G S B S B
G B G B G S B G S B
B O O G G G S G B B
O S T S O G B G S B
O B G B O B B S G B
S O G S B S G O O G
B B G O S O G G B G
O B G S B S O O O S
B S O B B G S O B O
S G S S B O O T B S
