O O S S S S G O S S
G S B S G G B G B B
B B G O T G B S G G
B B G B B O O O G B
O O G O G S O G G G
G O B O B S S B O O
O B O O G G S B B B
B G G B G B G G S B
B B S G T B O S S G
G G S O G O S B S B
