G S G S S G S G O B
G B O B S S B O S O
B O O S G O B O S O
G O O O S S S T O B
S G S B S O S B B G
G G B S G S S S S O
O O O B O B S G B G
B S O O G G G O S B
T S S O G S G O O G
O B B B G B S B O O
