G B B S B G S S S B
O S G S S O O G O B
O B O S B B S G G B
S B O G O O G B G S
S O G O G O S G O O
O B O O O S O O G O
B O B B O O B B O G
O S G G G S O G T B
S G O O O O B B S S
S B T B B S B S S O
